1111111111111111111111111111111111
1E0000000000000C00000C000000000001
1010010100100000101001000000010101
1010010010101000001001000000010101
100000000C01C000000000000000000C01
1000000000C11100C11111111111111111
1111111110000000000000111111110001
110000000000000C00000C000000000001
1010010100100000101001000000010101
1010010010101000001001000000010101
1P0000000C01C000000000000000000C01
1111111111111111111111111111111111